0000000000000111222211122222211111111111111111111111111111111111111111112222111122221110000000000000
0000000000011122211112222111112222222222222222222222222222222222222222211112222111122211100000000000
0000000001112221112222111122222111111111111111111111111111111111111111222211112222111222111000000000
0000000011222111222111122221111122222222222222222222222222222222222221111222211112221112221100000000
0000001112211122211122221111222221111111111111111111111111111111111122221111222211122211122111000000
0000011222112221112221111222211111222222222222222222222222222222222111122221111222111222112221100000
0000112211122111222111222211112222211111111111111111111111111111112222111122221112221112211122110000
0001122112221122211122211112222111114444444444444444444444444444111112222111122211122211222112211000
0011221122111221112221112222111144444444444444444444444444444444444411112222111222111221112211221100
0112211221122211222111222111144444444444444433333333333334444444444444411112221112221122211221122110
1122112211221112211122211144444444444443333333333333333333333344444444444411122211122111221122112211
1221122112211222112221114444444444433333333333333333333333333333344444444444111222112221122112211221
2211221122112211122111444444443333333333333333333333333333333333333333444444441112211122112211221122
2112211221122112221144444443333333333333333333333333333333333333333333333444444411222112211221122112
1122112211221122111444444333333333333333333333333333333333333333333333333334444441112211221122112211
1221122112211221144444433333333333333333333333333333333333333333333333333333344444411221122112211221
2211221122112211444443333333333333333333333333333333333333333333333333333333333444441122112211221122
2112211221122114444333333333333333333333333333333333333333333333333333333333333334444112211221122112
2122112211221144443333333333333333333333333333333333333333333333333333333333333333444411221122112212
1121122112211444433333333333333333333333333333333333333333333333333333333333333333344441122112211211
1221221122114443333333333333333333333333333333333333333333333333333333333333333333333444112211221221
2211211221144433333333333333333333333333333333333333333333333333333333333333333333333344411221121122
2112212211444333333333333333333333333333333333333333333333333333333333333333333333333334441122122112
2122112114443333333333333333333333333333333333333333333333333333333333333333333333333333444112112212
1121122144433333333333333333333333333333333333333333333333333333333333333333333333333333344412211211
1221221144433333333333333333333333333333333333333333333333333333333333333333333333333333344411221221
1211211444333333333333333333333333333333333333333333333333333333333333333333333333333333334441121121
2212214443333333333333333333333333333333333333333333333333333333333333333333333333333333333444122122
2112114433333333333333333333333333333333333333333333333333333333333333333333333333333333333344112112
2122144433333333333333333333333333333333333333333333333333333333333333333333333333333333333344412212
1121144333333333333333333333333333333333333333333333333333333333333333333333333333333333333334411211
1221444333333333333333333333333333333333333333333333333333333333333333333333333333333333333334441221
1211443333333333333333333333333333333333333333333333333333333333333333333333333333333333333333441121
1214443333333333333333333333333333333333333333333333333333333333333333333333333333333333333333444121
2214433333333333333333333333333333333333333333333333333333333333333333333333333333333333333333344122
2114433333333333333333333333333333333333333333333333333333333333333333333333333333333333333333344112
2144333333333333333333333333333333333333333333333333333333333333333333333333333333333333333333334412
2144333333333333333333333333333333333333333333333333333333333333333333333333333333333333333333334412
1144333333333333333333333333333333333333333333333333333333333333333333333333333333333333333333334411
1443333333333333333333333333333333333333333333333333333333333333333333333333333333333333333333333441
1443333333333333333333333333333333333333333333333333333333333333333333333333333333333333333333333441
1443333333333333333333333333333333333333333333333333333333333333333333333333333333333333333333333441
1443333333333333333333333333333333333333333333333333333333333333333333333333333333333333333333333441
4443111111333333333333333333333333333333333333333111333333333333333333333333333333333333331111113444
4431133333333333333333333333333333333333333333333111333333333333333333333333333333333333333333311344
4413333333333333333333333333333333333333333333333313333333333333333333333333333333333333333333333144
4133333333333333333333333333333333333333333333333313333333333333333333333333333333333333333333333314
1133333333333333333333333333333333333333333333333313333333333333333333333333333333333333333333333311
1333333333333333333333333333333333333333333333333313333333333333333333333333333333333333333333333331
1333333333333333333333333333333333333333333333333313333333333333333333333333333333333333333333333331
1333333333333333333333333333333333333333333333333313333333333333333333333333333333333333333333333331
1333333333333333333333333333333333333333333333333313333333333333333333333333333333333333333333333331
1133333333333333333333333333333333333333333333333313333333333333333333333333333333333333333333333311
4133333333333333333333333333333333333333333333333313333333333333333333333333333333333333333333333314
4413333333333333333333333333333333333333333333333313333333333333333333333333333333333333333333333144
4431133333333333333333333333333333333333333333333111333333333333333333333333333333333333333333311344
4443111111333333333333333333333333333333333333333111333333333333333333333333333333333333331111113444
1443333333333333333333333333333333333333333333333333333333333333333333333333333333333333333333333441
1443333333333333333333333333333333333333333333333333333333333333333333333333333333333333333333333441
1443333333333333333333333333333333333333333333333333333333333333333333333333333333333333333333333441
1443333333333333333333333333333333333333333333333333333333333333333333333333333333333333333333333441
1144333333333333333333333333333333333333333333333333333333333333333333333333333333333333333333334411
2144333333333333333333333333333333333333333333333333333333333333333333333333333333333333333333334412
2144333333333333333333333333333333333333333333333333333333333333333333333333333333333333333333334412
2114433333333333333333333333333333333333333333333333333333333333333333333333333333333333333333344112
2114433333333333333333333333333333333333333333333333333333333333333333333333333333333333333333344122
2214443333333333333333333333333333333333333333333333333333333333333333333333333333333333333333444121
1211443333333333333333333333333333333333333333333333333333333333333333333333333333333333333333441121
1221444333333333333333333333333333333333333333333333333333333333333333333333333333333333333334441221
1121144333333333333333333333333333333333333333333333333333333333333333333333333333333333333334411211
2122144433333333333333333333333333333333333333333333333333333333333333333333333333333333333344412212
2112114433333333333333333333333333333333333333333333333333333333333333333333333333333333333344112112
2212214443333333333333333333333333333333333333333333333333333333333333333333333333333333333444122122
1211211444333333333333333333333333333333333333333333333333333333333333333333333333333333334441121121
1221221144433333333333333333333333333333333333333333333333333333333333333333333333333333344411221221
1121122144433333333333333333333333333333333333333333333333333333333333333333333333333333344412211211
2122112114443333333333333333333333333333333333333333333333333333333333333333333333333333444112112212
2112212211444333333333333333333333333333333333333333333333333333333333333333333333333334441122122112
2211211221144433333333333333333333333333333333333333333333333333333333333333333333333344411221121122
1221221122114443333333333333333333333333333333333333333333333333333333333333333333333444112211221221
1121122112211444433333333333333333333333333333333333333333333333333333333333333333344441122112211211
2122112211221144443333333333333333333333333333333333333333333333333333333333333333444411221122112212
2112211221122114444333333333333333333333333333333333333333333333333333333333333334444112211221122112
2211221122112211444443333333333333333333333333333333333333333333333333333333333444441122112211221122
1221122112211221144444433333333333333333333333333333333333333333333333333333344444411221122112211221
1122112211221122111444444333333333333333333333333333333333333333333333333334444441112211221122112211
2112211221122112221144444443333333333333333333333333333333333333333333333444444411222112211221122112
2211221122112211122111444444443333333333333333333333333333333333333333444444441112211122112211221122
1221122112211222112221114444444444433333333333333333333333333333344444444444111222112221122112211221
1122112211221112211122211144444444444443333333333333333333333344444444444411122211122111221122112211
0112211221122211222111222111144444444444444433333333333334444444444444411112221112221122211221122110
0011221122111221112221112222111144444444444444444444444444444444444411112222111222111221112211221100
0001122112221122211122211112222111114444444444444444444444444444111112222211122211122211222112211000
0000112211122111222111222211112222211111111111111111111111111111122222111112221112221112211122110000
0000011222112221112221111222211111222222222222222222222222222222221111122222111222111222112221100000
0000001112211122211122221111222221111111111111111111111111111111111222221111122211122211122111000000
0000000011222111222111122221111122222222222222222222222222222222222211111222221112221112221100000000
0000000001112221112222111122222111111111111111111111111111111111111112222211111222111222111000000000
0000000000011122211112222111112222222222222222222222222222222222222222111112222211122211100000000000
0000000000000111222211112222211111111111111111111111111111111111111111122222111112221110000000000000
