1111111111111111111111111111111111111111111111111111111111111111111111111111111111111111111111111111
1000000000000000000000000000000000000000000000000000000000000000000000000110000000000000000000000001
1000000000000000000000000000000000000000000000000000000000000000000000000110000000000000000000000001
1000000000000000000000000000000000000000000000000000000000000000000000000110000000000000000000000001
1000000000000000000000000000000000000000000000000000000000000000000000000110000000000000000000000001
1000000000000000000000000000000000000000000000000000000000000000000000000110000000000000000000000001
1000000000000000000000000000000000000000000000000000000000000000000000000110000000000000000000000001
1000000000000000000000000000000000000000000000000000000000000000000000000110000000000000000000000001
1000000000000000000000000000000000000000000000000000000000000000000000000110000000000000000000000001
1000000000000000000000000000000000000000000000000000000000000000000000000110000000000000000000000001
1000000000000000000000000000000000000000000000000000000000000000000000000110000000000000000000000001
1000000000000000000000000000000000000000000000000000000000000000000000000110000000000000000000000001
1000000000000000000000000000000000000000000000000000000000000000000000000110000000000000000000000001
1000000000000000000000000000000000000000000000000000000000000000000000000110000000000000000000000001
1000000000000000000000000000000000000000000000000000000000000000000000000110000000000000000000000001
1000000000000000000000000000000000000000000000000000000000000000000000000110000000000000000000000001
1000000000000000000000000000000000000000000000000000000000000000000000000110000000000000000000000001
1000000000000000000000000000000000000000000000000000000000000000000000000110000000000000000000000001
1000000000000000000000000000000000000000000000000000000000000000000000000110000000000000000000000001
1000000000000000000000000000000000000000000000000000000000000000000000000110000000000000000000000001
1000000000000000000000000000000000000000000000000000000000000000000000000110000000000000000000000001
1000000000000000000000000000000000000000000000000000000000000000000000000110000000000000000000000001
1000000000000000000000000000000000000000000000000000000000000000000000000110000000000000000000000001
1000000000000000000000000000000000000000000000000000000000000000000000000110000000000000000000000001
1000000000000000000000000000000000000000000000000000000000000000000000000110000000000000000000000001
1000000000000000000000000000000000000000000000000000000000000000000000000110000000000000000000000001
1000000000000000000000000000000000000000000000000000000000000000000000000110000000000000000000000001
1000000000000000000000000000000000000000000000000000000000000000000000000110000000000000000000000001
1000000000000000000000000000000000000000000000000000000000000000000000000110000000000000000000000001
1111111111111111111111111100000000000000000000000000000001111111111111111110000000000000000000000001
1111111111111111111111111100000000000000000000000000000001111111111111111110000000000000000000000001
1000000000000000000000001100000000000000000000000000000001100000000000000000000000000000000000000001
1000000000000000000000001100000000000000000000000000000001100000000000000000000000000000000000000001
1000000000000000000000001100000000000000000000000000000001100000000000000000000000000000000000000001
1000000000000000000000001100000000000000000000000000000001100000000000000000000000000000000000000001
1000000000000000000000001100000000000000000000000000000001100000000000000000000000000000000000000001
1000000000000000000000001100000000000000000000000000000000000000000000000000000000000000000000000001
1000000000000000000000001100000000000000000000000000000000000000000000000000000000000000000000000001
1000000000000000000000001100000000000000000000000000000000000000000000000000000000000000000000000001
1000000000000000000000001100000000000000000000000000000000000000000000000000000000000000000000000001
1000000000000000000000001100000000000000000000000000000000000000000000000000000000000000000000000001
1000000000000000000000001100000000000000022222222222222200000000000000000000000000000000000000000001
1000000000000000000000001100000000002222222222222222222222000000000000000000000000000000000000000001
1000000000000000000000001100000000000222222222222222222222222000000000000000000000000000000000000001
1000000000000000000000001100000000000002222222222222222222222200000000000000000000000000000000000001
1000000000000000000000001100000000000222222222222222222222222000000000000000000000000000000000000001
1000000000000000000000001100000000000000222222222222222222222000000000000000000000000000000000000001
1000000000000000000000001100000000000022222222222222222222000000000000000000000000000000000000000001
1000000000000000000000001100000002222222222222222222222222000000000000000000000000000000000000000001
1000000000000000000000001100000000000222222222222222220000000000000000000000000000000000000000000001
1000000000000000000000001100000000022222222222222222222200000000000000000000000000000000000000000001
1000000000000000000000001100000000000022222222222222200000000000000000000000000000000000000000000001
1000000000000000000000001100000000000000222222222222222222222000000000000000000000000000000000000001
1000000000000000000000001100000000000022222222222222222222000000000000000000000000000000000000000001
1000000000000000000000001100000002222222222222222222222222000000000000000000000000000000000000000001
1000000000000000000000001100000000000222222222222222220000000000000000000000000000000000000000000001
1000000000000000000000001100000000022222222222222222222200000000000000000000000000000000000000000001
1000000000000000000000001100000000000022222222222222200000000000000000000000000000000000000000000001
1000000000000000000000001100000000000000000000000000000000000000000000000000000000000000000000000001
1000000000000000000000001100000000000000000000000000000000000000000000000000000000000000000000000001
1000000000000000000000001100000000000000000000000000000000000000000000000000000000000000000000000001
1000000000000000000000001100000000000000000000000000000000000000000000000000000000000000000000000001
1000000000000000000000001100000000000000000000000000000000000000000000000000000000000000000000000001
1000000000000000000000000000000000000000000000000000000000000000000000000000000000000000000000000001
1000000000000000000000000000000000000000000000000000000000000000000000000000000000000000000000000001
1000000000000000000000000000000000000000000000000000000000000000000000000000000000000000000000000001
1000000000000000000000000000000000000000000000000000000000000000000000000000000000000000000000000001
1000000000000000000000000000000000000000000000000000000000000000000000000000000000000000000000000001
1000000000000000000000000000000000000000000000000000000000000000000000000000000000000000000000000001
1000000000000000000000000000000000000000000000000000000000000000000000000000000000000000000000000001
1000000000000000000000000000000000000000000000000000000000000000000000000000000000000000000000000001
1000000000000000000000000000000000000000000000000000000000000000000000000000000000000000000000000001
1000000000000000000000000000000000000000000000000000000000000000000000000000000000000000000000000001
1000000000000000000000000000000000000000000000000000000000000000000000000000000000000000000000000001
1000000000000000000000000000000000000000000000000000000000000000000000000000000000000000000000000001
1000000000000000000000000000000000000000000000000000000000000000000000000000000000000000000000000001
1000000000000000000000000000000000000000000000000000000000000000000000000000000000000000000000000001
1000000000000000000000000000000000000000000000000000000000000000000000000000000000000000000000000001
1000000000000000000000000000000000000000000000000000000000000000000000000000000000000000000000000001
1000000000000000000000000000000000000000000000000000000000000000000000000000000000000000000000000001
1000000000000000000000000000000000000000000000000000000000000000000000000000000000000000000000000001
1000000000000000000000000000000000000000000000000000000000000000000000000000000000000000000000000001
1000000000000000000000000000000000000000000000000000000000000000000000000000000000000000000000000001
1000000000000000000000000000000000000000000000000000000000000000000000000000000000000000000000000001
1000000000000000000000000000000000000000000000000000000000000000000000000000000000000000000000000001
1000000000000000000000000000000000000000000000111111111111111111111111111111111111111111111111111111
1000000000000000000000000000000000000000000000111111111111111111111111111111111111111111111111111111
1000000000000000000000000000000000000000000000110000000000000000000000000000000000000000000000000001
1000000000000000000000000000000000000000000000110000000000000000000000000000000000000000000000000001
1000000000000000000000000000000000000000000000110000000000000000000000000000000000000000000000000001
1000000000000000000000000000000000000000000000110000000000000000000000000000000000000000000000000001
1000000000000000000000000000000000000000000000110000000000000000000000000000000000000000000000000001
1000000000000000000000000000000000000000000000110000000000000000000000000000000000000000000000000001
1000000000000000000000000000000000000000000000000000000000000000000000000000000000000000000000000001
1000000000000000000000000000000000000000000000000000000000000000000000000000000000000000000000000001
1000000000000000000000000000000000000000000000000000000000000000000000000000000000000000000000000001
1000000000000000000000000000000000000000000000000000000000000000000000000000000000000000000000000001
1000000000000000000000000000000000000000000000000000000000000000000000000000000000000000000000000001
1000000000000000000000000000000000000000000000000000000000000000000000000000000000000000000000000001
1111111111111111111111111111111111111111111111111111111111111111111111111111111111111111111111111111
