4444444444444444111111111111111111111111111111111111111111111111111111111111111111111144444444444444
4444444444441111111111111111111111111111111111111111111111111111111111111111111111111111444444444444
4444444444111111111111111111111111111111111111111111111111111111111111111111111111111111114444444444
4444444411111111111111111111111111111111111111111111111111111111111111111111111111111111111144444444
4444444111111111111111111111111111111111111111111111111111111111111111111111111111111111111114444444
4444441111111111000000000000000000000000000000002220000000000000000000000000000000001111111111444444
4444411111111000000000000000000000000000000000002220000000000000000000000000000000000001111111144444
4444111111100000000000000000000000000000000000002220000000000000000000000000000000000000011111114444
4441111111000000000000000000000000000000000000002220000000000000000000000000000000000000001111111444
4411111110000000000000000000000000000000000000002220000000000000000000000000000000000000000111111144
4411111100000000000000000000000000000000000000002220000000000000000000000000000000000000000011111144
4111111000000000000000000000000000000000000000002220000000000000000000000000000000000000000001111114
4111111000000000000000000000000000000000000000002220000000000000000000000000000000000000000001111114
4111110000000000000000000000000000000000000000002220000000000000000000000000000000000000000000111114
1111110000000000000000000000000000000000000000002220000000000000000000000000000000000000000000111111
1111100000000000000000000000000000000000000000002220000000000000000000000000000000000000000000011111
1111100000000000000000000000000000000000000000002220000000000000000000000000000000000000000000011111
1111100000000000000000000000000000000000000000002220000000000000000000000000000000000000000000011111
1111100000000000000000000000000000000000000000002220000000000000000000000000000000000000000000011111
1111100000000000000000000000000011100000000000002220000000000000111000000000000000000000000000011111
1111100000000000000000000000000011100000000000002220000000000000111000000000000000000000000000011111
1111100000000000000000000000000011100000000000002220000000000000111000000000000000000000000000011111
1111100000000000000000000000000011100000000000002220000000000000111000000000000000000000000000011111
1111100000000000000000000000000011100000000000002220000000000000111000000000000000000000000000011111
1111100000000000000000000000000011100000000000002220000000000000111000000000000000000000000000011111
1111100000000000000000000000000011100000000000002220000000000000111000000000000000000000000000011111
1111111111111111111111111111111111100000000000002220000000000000111111111111111111111111111111111111
1111111111111111111111111111111111100000000000002220000000000000111111111111111111111111111111111111
1111111111111111111111111111111111100000000000002220000000000000111111111111111111111111111111111111
1111100000000000000000000000000000000000000000002220000000000000000000000000000000000000000000011111
1111100000000000000000000000000000000000000000002220000000000000000000000000000000000000000000011111
1111100000000000000000000000000000000000000000002220000000000000000000000000000000000000000000011111
1111100000000000000000000000000000000000000000002220000000000000000000000000000000000000000000011111
1111100000000000000000000000000000000000000000002220000000000000000000000000000000000000000000011111
1111100000000000000000000000000000000000000000002220000000000000000000000000000000000000000000011111
1111100000000000000000000000000000000000000000002220000000000000000000000000000000000000000000011111
1111100000000000000000000000000000000000000000002220000000000000000000000000000000000000000000011111
1111100000000000000000000000000000000000000000002220000000000000000000000000000000000000000000011111
1111100000000000000000000000000000000000000000002220000000000000000000000000000000000000000000011111
1111100000000000000000000000000000000000000022222222222200000000000000000000000000000000000000011111
1111100000000000000000000000000000000000002222222222222220000000000000000000000000000000000000011111
1111100000000000000000000000000000000000022222222222222222000000000000000000000000000000000000011111
1111100000000000000000000000000000000000222224444444442222200000000000000000000000000000000000011111
1111100000000000000000000000000000000002222444444444444422220000000000000000000000000000000000011111
1111100000000000000000000000000000000002222444444444444422220000000000000000000000000000000000011111
1111100000000000000000000000000000000002224444444444444442220000000000000000000000000000000000011111
1111100000000000000000000000000000000002224444444444444442220000000000000000000000000000000000011111
1111100000000000000000000000000000000002224444444444444442220000000000000000000000000000000000011111
1111122222222222222222222222222222222222224444444444444442222222222222222222222222222222222222211111
1111122222222222222222222222222222222222224444444444444442222222222222222222222222222222222222211111
1111122222222222222222222222222222222222224444444444444442222222222222222222222222222222222222211111
1111100000000000000000000000000000000002224444444444444442220000000000000000000000000000000000011111
1111100000000000000000000000000000000002224444444444444442220000000000000000000000000000000000011111
1111100000000000000000000000000000000002224444444444444442220000000000000000000000000000000000011111
1111100000000000000000000000000000000002222444444444444422220000000000000000000000000000000000011111
1111100000000000000000000000000000000002222444444444444422220000000000000000000000000000000000011111
1111100000000000000000000000000000000000222224444444442222200000000000000000000000000000000000011111
1111100000000000000000000000000000000000022222222222222222000000000000000000000000000000000000011111
1111100000000000000000000000000000000000002222222222222220000000000000000000000000000000000000011111
1111100000000000000000000000000000000000000022222222222200000000000000000000000000000000000000011111
1111100000000000000000000000000000000000000000002220000000000000000000000000000000000000000000011111
1111100000000000000000000000000000000000000000002220000000000000000000000000000000000000000000011111
1111100000000000000000000000000000000000000000002220000000000000000000000000000000000000000000011111
1111100000000000000000000000000000000000000000002220000000000000000000000000000000000000000000011111
1111100000000000000000000000000000000000000000002220000000000000000000000000000000000000000000011111
1111100000000000555555555555555500000000000000002220000000000000000000000000000000000000000000011111
1111100000000005555555555555555550000000000000002220000000000000000000000000000000000000000000011111
1111100000000005555555555555555550000000000000002220000000000000000000000000000000000000000000011111
1111100000000005555555555555555550000000000000002220000000000000000000000000000000000000000000011111
1111100000000005555555555555555550000000000000002220000000000000000000000000000000000000000000011111
1111100000000005555555555555555550000000000000002220000000000000000000000000000000000000000000011111
1111100000000000555555555555555500000000000000002220000000000000000000000000000000000000000000011111
1111100000000000000000000000000000000000000000002220000000000000000000000000000000000000000000011111
1111100000000000000000000000000000000000000000002220000000000000000000000000000000000000000000011111
1111100000000000000000000000000000000000000000002220000000000000000000000000000000000000000000011111
1111100000000000000000000000000000000000000000002220000000000000000000000000000000000000000000011111
1111100000000000000000000000000000000000000000002220000000000000000000000000000000000000000000011111
1111100000000000000000000000000000000000000000002220000000000000000000000000000000000000000000011111
1111100000000000000000000000000000000000000000002220000000000000000000000000000000000000000000011111
1111100000000000000000000000000000000000000000002220000000000000000000000000000000000000000000011111
1111100000000000000000000000000000000000000000002220000000000000000000000000000000000000000000011111
1111100000000000000000000000000000000000000000002220000000000000000000000000000000000000000000011111
1111100000000000000000000000000000000000000000002220000000000000000000000000000000000000000000011111
1111100000000000000000000000000000000000000000002220000000000000000000000000000000000000000000011111
1111100000000000000000000000000000000000000000002220000000000000000000000000000000000000000000011111
1111110000000000000000000000000000000000000000002220000000000000000000000000000000000000000000111111
4111110000000000000000000000000000000000000000002220000000000000000000000000000000000000000000111114
4111111000000000000000000000000000000000000000002220000000000000000000000000000000000000000001111114
4111111000000000000000000000000000000000000000002220000000000000000000000000000000000000000001111114
4411111100000000000000000000000000000000000000002220000000000000000000000000000000000000000011111144
4411111110000000000000000000000000000000000000002220000000000000000000000000000000000000000111111144
4441111111000000000000000000000000000000000000002220000000000000000000000000000000000000001111111444
4444111111100000000000000000000000000000000000002220000000000000000000000000000000000000011111114444
4444411111111000000000000000000000000000000000002220000000000000000000000000000000000001111111144444
4444441111111111000000000000000000000000000000002220000000000000000000000000000000001111111111444444
4444444111111111111111111111111111111111111111111111111111111111111111111111111111111111111114444444
4444444411111111111111111111111111111111111111111111111111111111111111111111111111111111111144444444
4444444444111111111111111111111111111111111111111111111111111111111111111111111111111111114444444444
4444444444441111111111111111111111111111111111111111111111111111111111111111111111111111444444444444
4444444444444441111111111111111111111111111111111111111111111111111111111111111111111444444444444444
