2222222222222221111111111111111111111111111111111111111111111111111111111111111111111222222222222222
2222222222221111111111111111111111111111111111111111111111111111111111111111111111111111222222222222
2222222222111111111111111111111111111111111111111111111111111111111111111111111111111111112222222222
2222222211111111111111111111111111111111111111111111111111111111111111111111111111111111111122222222
2222222111111111111111111111111111111111111111111111111111111111111111111111111111111111111112222222
2222221111111111000000000000000000000000000000002220000000000000000000000000000000001111111111222222
2222211111111000000000000000000000000000000000002220000000000000000000000000000000000001111111122222
2222111111100000000000000000000000000000000000002220000000000000000000000000000000000000011111112222
2221111111000000000000000000000000000000000000002220000000000000000000000000000000000000001111111222
2211111110000000000000000000000000000000000000002220000000000000000000000000000000000000000111111122
2211111100000000000000000000000000000000000000002220000000000000000000000000000000000000000011111122
2111111000000000000000000000000000000000000000002220000000000000000000000000000000000000000001111110
2111111000000000000000000000000000000000000000002220000000000000000000000000000000000000000001111110
2111110000000000000000000000000000000000000000002220000000000000000000000000000000000000000000111110
1111110000000000000000000000000000000000000000002220000000000000000000000000000000000000000000111110
1111100000000000000000000000000000000000000000002220000000000000000000000000000000000000000000011110
1111100000000000000000000000000000000000000000002220000000000000000000000000000000000000000000011110
1111100000000000000000000000000000000000000000002220000000000000000000000000000000000000000000011110
1111100000000000000000000000000000000000000000002220000000000000000000000000000000000000000000011110
1111100000000000000000000000000000000000000000002220000000000000000000000000000000000000000000011110
1111100000000000000000000000000000000000000000002220000000000000000000000000000000000000000000011110
1111100000000000000000000000000000000000000000002220000000000000000000000000000000000000000000011110
1111100000000000000000000000000000000000000000002220000000000000000000000000000000000000000000011110
1111100000000000000000000000000000000000000000002220000000000000000000000000000000000000000000011110
1111111111111111111111111111111000000000000000002220000000000000000011111111111111111111111111111110
1111111111111111111111111111111000000000000000002220000000000000000011111111111111111111111111111110
1111111111111111111111111111111000000000000000002220000000000000000011111111111111111111111111111110
1111100000000000000000000000000000000000000000002220000000000000000000000000000000000000000000011110
1111100000000000000000000000000000000000000000002220000000000000000000000000000000000000000000011110
1111100000000000000000000000000000000000000000002220000000000000000000000000000000000000000000011110
1111100000000000000000000000000000000000000000002220000000000000000000000000000000000000000000011110
1111100000000000000000000000000000000000000000002220000000000000000000000000000000000000000000011110
1111100000000000000000000000000000000000000000002220000000000000000000000000000000000000000000011110
1111100000000000000000000000000000000000000000002220000000000000000000000000000000000000000000011110
1111100000000000000000000000000000000000000000002220000000000000000000000000000000000000000000011110
1111100000000000000000000000000000000000000000002220000000000000000000000000000000000000000000011110
1111100000000000000000000000000000000000000000002220000000000000000000000000000000000000000000011110
1111100000000000000000000000000000000000000000002220000000000000000000000000000000000000000000011110
1111100000000000000000000000000000000000000000002220000000000000000000000000000000000000000000011110
1111100000000000000000000000000000000000000022222222222200000000000000000000000000000000000000011110
1111100000000000000000000000000000000000002222222222222220000000000000000000000000000000000000011110
1111100000000000000000000000000000000000022222222222222222000000000000000000000000000000000000011110
1111100000000000000000000000000000000000222220000000002222200000000000000000000000000000000000011110
1111100000000000000000000000000000000002222000000000000022220000000000000000000000000000000000011110
1111100000000000000000000000000000000002222000000000000022220000000000000000000000000000000000011110
1111100000000000000000000000000000000002220000000000000002220000000000000000000000000000000000011110
1111100000000000000000000000000000000002220000000000000002220000000000000000000000000000000000011110
1111100000000000000000000000000000000002220000000000000002220000000000000000000000000000000000011110
1111122222222222222222222222222222222222220000000000000002222222222222222222222222222222222222211110
1111122222222222222222222222222222222222220000000000000002222222222222222222222222222222222222211110
1111122222222222222222222222222222222222220000000000000002222222222222222222222222222222222222211110
1111100000000000000000000000000000000002220000000000000002220000000000000000000000000000000000011110
1111100000000000000000000000000000000002220000000000000002220000000000000000000000000000000000011110
1111100000000000000000000000000000000002220000000000000002220000000000000000000000000000000000011110
1111100000000000000000000000000000000002222000000000000022220000000000000000000000000000000000011110
1111100000000000000000000000000000000002222000000000000022220000000000000000000000000000000000011110
1111100000000000000000000000000000000000222220000000002222200000000000000000000000000000000000011110
1111100000000000000000000000000000000000022222222222222222000000000000000000000000000000000000011110
1111100000000000000000000000000000000000002222222222222220000000000000000000000000000000000000011110
1111100000000000000000000000000000000000000022222222222200000000000000000000000000000000000000011110
1111100000000000000000000000000000000000000000002220000000000000000000000000000000000000000000011110
1111100000000000000000000000000000000000000000002220000000000000000000000000000000000000000000011110
1111100000000000000000000000000000000000000000002220000000000000000000000000000000000000000000011110
1111100000000000000000000000000000000000000000002220000000000000000000000000000000000000000000011110
1111100000000000000000000000000000000000000000002220000000000000000000000000000000000000000000011110
1111100000000000000000000000000000000000000000002220000000000000000000000000000000000000000000011110
1111100000000000000000000000000000000000000000002220000000000000000000000000000000000000000000011110
1111100000000000000000000000000000000000000000002220000000000000000000000000000000000000000000011110
1111100000000000000000000000000000000000000000002220000000000000000000000000000000000000000000011110
1111100000000000000000000000000000000000000000002220000000000000000000000000000000000000000000011110
1111100000000000000000000000000000000000000000002220000000000000000000000000000000000000000000011110
1111100000000000000000000000000000000000000000002220000000000000000000000000000000000000000000011110
1111100000000000000000000000000000000000000000002220000000000000000000000000000000000000000000011110
1111100000000000000000000000000000000000000000002220000000000000000000000000000000000000000000011110
1111100000000000000000000000000000000000000000002220000000000000000000000000000000000000000000011110
1111100000000000000000000000000000000000000000002220000000000000000000000000000000000000000000011110
1111100000000000000000000000000000000000000000002220000000000000000000000000000000000000000000011110
1111100000000000000000000000000000000000000000002220000000000000000000000000000000000000000000011110
1111100000000000000000000000000000000000000000002220000000000000000000000000000000000000000000011110
1111100000000000000000000000000000000000000000002220000000000000000000000000000000000000000000011110
1111100000000000000000000000000000000000000000002220000000000000000000000000000000000000000000011110
1111100000000000000000000000000000000000000000002220000000000000000000000000000000000000000000011110
1111100000000000000000000000000000000000000000002220000000000000000000000000000000000000000000011110
1111100000000000000000000000000000000000000000002220000000000000000000000000000000000000000000011110
1111100000000000000000000000000000000000000000002220000000000000000000000000000000000000000000011110
1111110000000000000000000000000000000000000000002220000000000000000000000000000000000000000000111110
2111110000000000000000000000000000000000000000002220000000000000000000000000000000000000000000111112
2111111000000000000000000000000000000000000000002220000000000000000000000000000000000000000001111112
2111111000000000000000000000000000000000000000002220000000000000000000000000000000000000000001111112
2211111100000000000000000000000000000000000000002220000000000000000000000000000000000000000011111122
2211111110000000000000000000000000000000000000002220000000000000000000000000000000000000000111111122
2221111111000000000000000000000000000000000000002220000000000000000000000000000000000000001111111222
2222111111100000000000000000000000000000000000002220000000000000000000000000000000000000011111112222
2222211111111000000000000000000000000000000000002220000000000000000000000000000000000001111111122222
2222221111111111000000000000000000000000000000002220000000000000000000000000000000001111111111222222
2222222111111111111111111111111111111111111111111111111111111111111111111111111111111111111112222222
2222222211111111111111111111111111111111111111111111111111111111111111111111111111111111111122222222
2222222222111111111111111111111111111111111111111111111111111111111111111111111111111111112222222222
2222222222221111111111111111111111111111111111111111111111111111111111111111111111111111222222222222
2222222220000000000000000000000000000000000000000000000000000000000000000000000000000000000002222222
