7777777777777777777777777777777777777777777777777777777777777777777777777777777777777777777777777777
7777777777777777777777777777777777777777777777777777777777777777777777777777777777777777777777777777
7777777777777777777777777777777777777777777777777777777777777777777777777777777777777777777777777777
7777777777777777777777777777777777777777777777777777777777777777777777777777777777777777777777777777
7777777666666666666666666666666666666666666666666666666666666666666666666666666666666666666667777777
7777776666666666666666666666666666666666666666666666666666666666666666666666666666666666666666777777
7777766666666666666666666666666666666666666666666666666666666666666666666666666666666666666666677777
7777666666666666666666666666666666666666666666666666666666666666666666666666666666666666666666667777
7777666666666666666666666666666666666666666666666666666666666666666666666666666666666666666666667777
7777666666666666666666666666666666666666666666666666666666666666666666666666666666666666666666667777
7777766666666666666666666666666666666666666666666666666666666666666666666666666666666666666666667777
7777766666666666666666666666666666666666666666666666666666666666666666666666666666666666666666667777
7777766666666666666666666666666666666666666666666666666666666666666666666666666666666666666666667777
7777776666666666666666666666666666666666666666666666666666666777777666666666666666666666666666667777
7777777666666666666666666666666666666666666666666666666666667777777776666666666666666666666666667777
7777777766666666666666666666666666666666666666666666666666677777777777666666666666666666666666667777
7777777766666666666666666666666666666666666666666666666666777777777777766666666666666666666666667777
7777777776666666666666666666666666666666666666666666666666777776677777776666666666666666666666667777
7777777776666666666666666666666666666666666666666666666667777777667777777666666666666666666666667777
7777777776666666666666666666666666666666666666666666666667777767677777777666666666666666666666667777
7777777777666666666666666666666666666666666666666666666667777667777777777666666666666666666666667777
7777667777766666666666666666666666666666666666666666666666777777777777776666666666666666666666667777
7777667777777666666666666666666666666666666666666666666666777777777777766666666666666666666666667777
7777666777777777666666666666666666666666666666666666666666677777777666666666666666666666666666667777
7777666677777777777666666666666666666666666666666666666666667777666666666666666666666666666666667777
7777666667777777777776666666666666666666666666666666666666666666666666666666666666666666666666667777
7777666666666777777777766666666666666666666666666666666666666666666666666666666666666666666666667777
7777666666666667777777776666666666666666666666666666666666666666666666666666666666666666666666667777
7777666666666666777777777776666666666666666666666666666666666666666666666666666666666666666666667777
7777666666666666677777777777766666666666666666666666666666666666666666666666666666666666666666667777
7777666666666666666677777777777666666666666666666666666666666666666666666666666666666666666666667777
7777666666666666666666667777777776666666666666666666666666666666666666666666666666666666666666667777
7777666666666666666666666667777777666666666666666666666666666666666666666666666666666666666666667777
7777666666666666666666666666777777666666666666666666666666666666666666666666666666666666666666667777
7777666666666666666666666666666666666666666666666666666666666666666666666666666666666666666666667777
7777666666666666666666666666666666666666666666666666666666666666666666666666666666666666666666667777
7777666666666666666666666666666666666666666666666666666666666666666666666666666666666666666666777777
7777666666666666666666666666666666666666666666666666666666666666666666666666666666666666666677777777
7777666666666666666666666666666666666666666666666666666666666666666666666666666666666666667777777777
7777666666666666666666666666666666666666666666666666666666666666666666666666666666666777777777777777
7777666666666666666666666666666666666666666666666666666666666666666666666666666666677777777777777777
7777666666666666666666666666666666666666666666666666666666666666666666666666666667777777777777777777
7777666666666666666666666666666666666666666666666666666666666666666666666666667777777777777777777777
7777666666666666666666666666666666666666666666666666666666666666666666666777777777777766666666777777
7777666666666666666666666666666666666666666666666666666666666666666666677777777777776666666666677777
7777666666666666666666666666666666666666666666666666666666666666666667777777777776666666666666677777
7777666666666666666666666666677766666677666666666666666666666666666777777777776666666666666666667777
7777666666666666666666666666777776677777766666666666666666666666677777777776666666666666666666667777
7777666666666666666666666667777777777777776666666666666666666666677777776666666666666666666666667777
7777666666666666666666666667777777777777777666666666666666666666666666666666666666666666666666667777
7777666666666666666666666667777777777767777766666666666666666666666666666666666666666666666666667777
7777666666666666666666666666777777766667777766666666666666666666666666666666666666666666666666667777
7777666666666666666666666666677777776777777766666666666666666666666666666666666666666666666666667777
7777666666666666666666666666667777777777777666666666666666666666666666666666666666666666666666667777
7777666666666666666666666666666677777777766666666666666666666666666666666666666666666666666666667777
7777666666666666666666666666666666677777666666666666666666666666666666666666666666666666666666667777
7777666666666666666666666666666666666666666666666666666666666666666666666666666666666666666666667777
7777666666666666666666666666666666666666666666666666666666666666666666666666666666666666666666667777
7777666666666666666666666666666666666666666666666666666666666666666666666666666666666666666666667777
7777666666666666666666666666666666666666666666666666666666666666666666666666666666666666666666667777
7777666666666666666666666666666666666666666666666666666666666666666666666666666666666666666666667777
7777666666666666666666666666666666666666666666666666666666666666666666666666666666666666666666667777
7777666666666666666666666666666666666666666666666666666666666666666666666666666666666666666666667777
7777666666666666666666666666666666666666666666666666666666666666666666666666666666666666666666667777
7777666666666666666666666666666666666666666666666666666666666666666666666666666666666666666666667777
7777666666666666666666666666666666666666666666666666666666666666666666666666666666666666666666667777
7777666666666666666666666666666666666666666666666666666666666666666666666666666666666666666666667777
7777666666666666666666666666666666666666666666666666666666666666666666666666666666666666666666667777
7777666666666666666666666666666666666666666666666666666666666666666666666666666666666666666666667777
7777666666666666666666666666666666666666666666666666666666666666666666666666666666666666666666667777
7777666666666666666666666666666666667766666666666666666666666666666666666666666666666666666666667777
7777666666666666666666666666666666677766666666666666666666666666677776666666666666666666666666667777
7777666666666666666666666666666666677766666666666666666666666667777777766666666666666666666666667777
7777666666666666666666666666666666777766666666666666666666666677777777766666666666666666666666667777
7777666666666666666666666666666677777766666666666666666666666777777777776666666666666666666666667777
7777666666666666666666666666666777777666666666666666666666677777776677777666666666666666666666667777
7777666666666666666666666666667777777666666666666666666666777777766777777666666666666666666666667777
7777666666666666666666666666677777776666666666666666666667777776676767777666666666666666666666667777
7777666666666666666666666666677777766666666666666666666667777767777767777666666666666666666666667777
7777666666666666666666666666777777666666666666666666666677777777777777777666666666666666666666667777
7777666666666666666666666666777776666666666666666666666777777777777777777666666666666666666666667777
7777666666666666666666666667777776666666666666666666666777777777777777776666666666666666666666667777
7777666666666666666666666667777776666666666666666666666677777777666777766666666666666666666666667777
7777666666666666666666666667777776666666666666666666666667777766666677666666666666666666666666667777
7777666666666666666666666677777766666666666666666666666666677666666666666666666666666666666666667777
7777666666666666666666666677777666666666666666666666666666666666666666666666666666666666666666667777
7777666666666666666666666777776666666666666666666666666666666666666666666666666666666666666666667777
7777666666666666666666666777776666666666666666666666666666666666666666666666666666666666666666667777
7777666666666666666666666777766666666666666666666666666666666666666666666666666666666666666666667777
7777666666666666666666667777766666666666666666666666666666666666666666666666666666666666666666667777
7777666666666666666666667777766666666666666666666666666666666666666666666666666666666666666666667777
7777666666666666666666667777766666666666666666666666666666666666666666666666666666666666666666667777
7777666666666666666666677777766666666666666666666666666666666666666666666666666666666666666666667777
7777766666666666666667777777666666666666666666666666666666666666666666666666666666666666666666677777
7777776666666666667777777777666666666666666666666666666666666666666666666666666666666666666666777777
7777777666666666777777777766666666666666666666666666666666666666666666666666666666666666666667777777
7777777777777777777777777777777777777777777777777777777777777777777777777777777777777777777777777777
7777777777777777777777777777777777777777777777777777777777777777777777777777777777777777777777777777
7777777777777777777777777777777777777777777777777777777777777777777777777777777777777777777777777777
7777777777777777777777777777777777777777777777777777777777777777777777777777777777777777777777777777
