0000000000000111888811188888811111111111111111111111111111111111111111118888111188881110000000000000
0000000000011188811118888111118888888888888888888888888888888888888888811118888111188811100000000000
0000000001118881118888111188888111111111111111111111111111111111111111888811118888111888111000000000
0000000011888111888111188881111188888888888888888888888888888888888881111888811118881118881100000000
0000001118811188811188881111888881111111111111111111111111111111111188881111888811188811188111000000
0000011888118881118881111888811111888888888888888888888888888888888111188881111888111888118881100000
0000118811188111888111888811118888811111111111111111111111111111118888111188881118881118811188110000
0001188118881188811188811118888111114444444444444444444444444444111118888111188811188811888118811000
0011881188111881118881118888111144444444444444444444444444444444444411118888111888111881118811881100
0118811881188811888111888111144444444444444433333333333334444444444444411118881118881188811881188110
1188118811881118811188811144444444444443333333333333333333333344444444444411188811188111881188118811
1881188118811888118881114444444444433333333333333333333333333333344444444444111888118881188118811881
8811881188118811188111444444443333333333333333333333333333333333333333444444441118811188118811881188
8118811881188118881144444443333333333333333333333333333333333333333333333444444411888118811881188118
1188118811881188111444444333333333333333333333333333333333333333333333333334444441118811881188118811
1881188118811881144444433333333333333333333333333333333333333333333333333333344444411881188118811811
8811881188118811444443333333333333333333333333333333333333333333333333333333333444441188118811881188
8118811881188114444333333333333333333333333333333333333333333333333333333333333334444118811881188118
8188118811881144443333333333333333333333333333333333333333333333333333333333333333444411881188118818
1181188118811444433333333333333333333333333333333333333333333333333333333333333333344441188118811811
1881881188114443333333333333333333333333333333333333333333333333333333333333333333333444118811881881
8811811881144433333333333333333333333333333333333333333333333333333333333333333333333344411881181188
8118818811444333333333333333333333333333333333333333333333333333333333333333333333333334441188188118
8188118114443333333333333333333333333333333333333333333333333333333333333333333333333333444118118818
1181188144433333333333333333333333333333333333333333333333333333333333333333333333333333344418811811
1881881144433333333333333333333333333333333333333333333333333333333333333333333333333333344411881881
1811811444333333333333333333333333333333333333333333333333333333333333333333333333333333334441181181
8818814443333333333333333333333333333333333333333333333333333333333333333333333333333333333444188188
8118114433333333333333333333333333333333333333333333333333333333333333333333333333333333333344118118
8188144433333333333333333333333333333333333333333333333333333333333333333333333333333333333344418818
1181144333333333333333333333333333333333333333333333333333333333333333333333333333333333333334411811
1881444333333333333333333333333333333333333333333333333333333333333333333333333333333333333334441881
1811443333333333333333333333333333333333333333333333333333333333333333333333333333333333333333441181
1814443333333333333333333333333333333333333333333333333333333333333333333333333333333333333333444181
8814433333333333333333333333333333333333333333333333333333333333333333333333333333333333333333344188
8114433333333333333333333333333333333333333333333333333333333333333333333333333333333333333333344118
8144333333333333333333333333333333333333333333333333333333333333333333333333333333333333333333334418
8144333333333333333333333333333333333333333333333333333333333333333333333333333333333333333333334418
1144333333333333333333333333333333333333333333333333333333333333333333333333333333333333333333334411
1443333333333333333333333333333333333333333333333111333333333333333333333333333333333333333333333441
1443333333333333333333333333333333333333333333333111333333333333333333333333333333333333333333333441
1443333333333333333333333333333333333333333333311111113333333333333333333333333333333333333333333441
1443111111333333333333333333333333333333333333311111113333333333333333333333333333333333331111113441
4441111111333333333333333333333333333333333333311111113333333333333333333333333333333333331111111444
4411133333333333333333333333333333333333333333333111333333333333333333333333333333333333333333311144
4111333333333333333333333333333333333333333333333111333333333333333333333333333333333333333333331114
1113333333333333333333333333333333333333333333333111333333333333333333333333333333333333333333333111
1133333333333333333333333333333333333333333333333111333333333333333333333333333333333333333333333311
1333333333333333333333333333333333333333333333333111333333333333333333333333333333333333333333333331
1333333333333333333333333333333333333333333333333111333333333333333333333333333333333333333333333331
1333333333333333333333333333333333333333333333333111333333333333333333333333333333333333333333333331
1333333333333333333333333333333333333333333333333111333333333333333333333333333333333333333333333331
1133333333333333333333333333333333333333333333333111333333333333333333333333333333333333333333333311
1113333333333333333333333333333333333333333333333111333333333333333333333333333333333333333333333111
4111333333333333333333333333333333333333333333333111333333333333333333333333333333333333333333331114
4411133333333333333333333333333333333333333333333111333333333333333333333333333333333333333333311144
4441111111333333333333333333333333333333333333311111113333333333333333333333333333333333331111111444
1443111111333333333333333333333333333333333333311111113333333333333333333333333333333333331111113441
1443333333333333333333333333333333333333333333311111113333333333333333333333333333333333333333333441
1443333333333333333333333333333333333333333333333111333333333333333333333333333333333333333333333441
1443333333333333333333333333333333333333333333333111333333333333333333333333333333333333333333333441
1144333333333333333333333333333333333333333333333333333333333333333333333333333333333333333333334411
8144333333333333333333333333333333333333333333333333333333333333333333333333333333333333333333334418
8144333333333333333333333333333333333333333333333333333333333333333333333333333333333333333333334418
8114433333333333333333333333333333333333333333333333333333333333333333333333333333333333333333344118
8114433333333333333333333333333333333333333333333333333333333333333333333333333333333333333333344188
8814443333333333333333333333333333333333333333333333333333333333333333333333333333333333333333444181
1811443333333333333333333333333333333333333333333333333333333333333333333333333333333333333333441181
1881444333333333333333333333333333333333333333333333333333333333333333333333333333333333333334441881
1181144333333333333333333333333333333333333333333333333333333333333333333333333333333333333334411811
8188144433333333333333333333333333333333333333333333333333333333333333333333333333333333333344418818
8118114433333333333333333333333333333333333333333333333333333333333333333333333333333333333344118118
8818814443333333333333333333333333333333333333333333333333333333333333333333333333333333333444188188
1811811444333333333333333333333333333333333333333333333333333333333333333333333333333333334441181181
1881881144433333333333333333333333333333333333333333333333333333333333333333333333333333344411881881
1181188144433333333333333333333333333333333333333333333333333333333333333333333333333333344418811811
8188118114443333333333333333333333333333333333333333333333333333333333333333333333333333444118118818
8118818811444333333333333333333333333333333333333333333333333333333333333333333333333334441188188118
8811811881144433333333333333333333333333333333333333333333333333333333333333333333333344411881181188
1881881188114443333333333333333333333333333333333333333333333333333333333333333333333444118811881881
1181188118811444433333333333333333333333333333333333333333333333333333333333333333344441188118811811
8188118811881144443333333333333333333333333333333333333333333333333333333333333333444411881188118818
8118811881188114444333333333333333333333333333333333333333333333333333333333333334444118811881188118
8811881188118811444443333333333333333333333333333333333333333333333333333333333444441188118811881188
1881188118811881144444433333333333333333333333333333333333333333333333333333344444411881188118811881
1188118811881188111444444333333333333333333333333333333333333333333333333334444441118811881188118811
8118811881188118881144444443333333333333333333333333333333333333333333333444444411888118811881188118
8811881188118811188111444444443333333333333333333333333333333333333333444444441118811188118811881188
1881188118811888118881114444444444433333333333333333333333333333344444444444111888118881188118811881
1188118811881118811188811144444444444443333333333333333333333344444444444411188811188111881188118811
0118811881188811888111888111144444444444444433333333333334444444444444411118881118881188811881188110
0011881188111881118881118888111144444444444444444444444444444444444411118888111888111881118811881100
0001188118881188811188811118888111114444444444444444444444444444111118888811188811188811888118811000
0000118811188111888111888811118888811111111111111111111111111111188888111118881118881118811188110000
0000011888118881118881111888811111888888888888888888888888888888881111188888111888111888118881100000
0000001118811188811188881111888881111111111111111111111111111111111888881111188811188811188111000000
0000000011888111888111188881111188888888888888888888888888888888888811111888881118881118881100000000
0000000001118881118888111188888111111111111111111111111111111111111118888811111888111888111000000000
0000000000011188811118888111118888888888888888888888888888888888888888111118888811188811100000000000
0000000000000111888811118888811111111111111111111111111111111111111111188888111118881110000000000000

single_spawn: (10, 50)
duel_spawns: [(10,50),(90,50)]
chaser_spawns: [(90,50),(80,40),(80,60)]
