7777777777777777777777777777777777777777777777777777777777777777777777777777777777777777777777777777
7777777777777777777777777777777777777777777777777777777777777777777777777777777777777777777777777777
7777333333333333333333333333333333333333333333333333333333333333333333333333333333333333333333337777
7773333333333333333333333333333333333333333333333333333333333333333333333333333333333333333333333777
7733333333333333333333333333333333333333333333333333333333333333333333333333333333333333333333333377
7733333333333333333333333333333333333333333333333333333333333333333333333333333333333333333333333377
7733333333333333333333333333333333333333333333333333333333333333333333333333333333333333333333333377
7733333333333333333333333333333333333333333333333333333333333333333333333333333333333333333333333377
7733333333333333333333333333333333333311333333333333333333333333333333333333333333333333333333333377
7733333333331111333333333333333333333311333333333333333333333333333333333333333333333333333333333377
7733333333311111133333333333333333333311333333333333333333333333333333333333333333333333333333333377
7733333333111331133333333333333333333311333333333333333333333333333333333333333333333333333333333377
7733333333113333333333333333333333333311333333333333333331111333333333333333333333333333333333333377
7733333333113333333331111333331111133311333331111133333111111333333333333333333333333333333333333377
7733333333113333333311111133311111113311333331111113333111133333333333333333333333333333333333333377
7733333333113333333311331133311331113311333331131113333111333333333333333333333333333333333333333377
7733333333111333311311331133311331113311333331111113333311111333333333333333333333333333333333333377
7733333333111111111311111133311331133311133331111333333331111133333333333333333333333333333333333377
7733333333331111113331111333311111133311113331113331133333111133333333333333333333333333333333333377
7733333333333333333333333333331111333331113331111111131111111333333333333333333333333333333333333377
7733333333333333333333333333333333333333333333111111131111113333333333333333333333333333333333333377
7733333332222222222222222222222222222222222223333333333333333333333333333333333333333333333333333377
7733333333333333333333333333333333333333333322222222222222222222233333333333333333333333333333333377
7733333333333333333333333333333333333333333333333333333333333333333311333333333333333333333333333377
7733333333333333333333333333333333311111333333333333113333333333333311333333333333333333333333333377
7733333333333333333333333333333333311111333333333333113333333333333311333333333333333333333333333377
7733333333333333333333333333333333311333333333333333333333311111133311333333333333333333333333333377
7733333333333333333333333333333333311133333331111133311333111111113311333333333333333333333333333377
7733333333333333333333333333333333311111113311111113311333111331113311333333333333333333333333333377
7733333333333333333333333333333333333311111311331113311333111111113311333333333333333333333333333377
7733333333333333333333333333333333333333111311133113311333111111333311333333333333333333333333333377
7733333333333333333333333333333333333333311331131113311133311333333311333333333333333333333333333377
7733333333333333333333333333333331133333111331111113311133311133333311133333333333333333333333333377
7733333333333333333333333333333331111111111331111333311133331111113311113333333333333333333333333377
7733333333333333333333333333333333111111113331133333333333333111113331113333333333333333333333333377
7733333333333333333333333333333333333333333331133333333333333333333333333333333333333333333333333377
7733333333333333333333333333333322222222222231132222222222222222222222222233333333333333333333333377
7733333333333333333333333333333333333333333331133333333333333333333333333333333333333333333333333377
7733333333333333333333333333333333333333333331133333333333333333333333333333333333333333333333333377
7733333333333333333333333333333333333333333333333333333333333333333333333333333333333333333333333377
7733333333333333333333333333333333333333333333333333333333333333333333333333333333333333333333333377
7733333333333333333333333333333333333333333333333333333333333333333333333333333333333333333333333377
7733333333333333333333333333333333333333333333333333333333333333333333333333333333333333333333333377
7733333333333333333333333333333333333333333333333333333333333333333333333333333333333333333333333377
7733333333333333333333333333333333333333333333333333333333333333333333333333333333333333333333333377
7733333333333333333333333333333333333333333333333333333333333333333333333333333333333333333333333377
7733333333333333333333333333333333333333333333333333333333333333333333333333333333333333333333333377
7733333333333333333333333333333333333333333333333333333333333333333333333333333333333333333333333377
7733333333333333333333333333333333333333333333333333333333333333333333333333333333333333333333333377
7733333333333333333333333333333333333333333333333333333333333333333333333333333333333333333333333377
7733333333333333333333333333333333333333333333333333333333333333333333333333333333333333333333333377
7733333333333333333333333333333333333333333333333333333333333333333333333333333333333333333333333377
7733333333333333333333333333333333333333333333333333333333333333333333333333333333333333333333333377
7733333333333333333333333333333333333333333333333333333333333333333333333333333333333333333333333377
7733333333333333333333333333333333333333333333333333333333333333333333333333333333333333333333333377
7733333333333333333333333333333333333333333333333333333333333333333333333333333333333333333333333377
7733333333333333333333333333333333333333333333333333333333333333333333333333333333333333333333333377
7733133311333333333333333333333333333333333333333333333333333333333333333333333333333333333333333377
7733113313111131111333333333333333333333333333333333333333333333333333333333333333333333333333333377
7733313133133133131331333333333333333333333333333333333333333333333333333333333333333333333333333377
7733311133131131131333333333333333333333333333333333333333333333333333333333333333333333333333333377
7733331333111331311331333333333333333333333333333333333333333333333333333333333333333333333333333377
7733333333333331313333333333333333333333333333333333333333333333333333333333333333333333333333333377
7733333333333333333333333333333333333333333333333333333333333333333333333333333333333333333333333377
7733333333333333333333333333333333333333333333333333333333333333333333333333333333333333333333333377
7733333333333333333333333333333333333333333333333333333333333333333333333333333333333333333333333377
7733333333333333333333333333333333333333333333333333333333333333333333333333333333333333333333333377
7733333333333333333333333333333333333333333333333333333333333333333333331333133333331333133333333377
7731113133333333333333333333333333333311113333333333313333333333333333331131133333331333133333333377
7711133133333333333333333333333333333333313313313333313333333333333333331131133333311133133331333377
7733133111331113111111131113311133333333113313313113111313133111333333313111131113331333133333311377
7733133113131313313113131313313333333311111313113133313313131133333333313313131313331333111131313377
7733133133131113313133131111311133133313133311133311311313133113333133313333131111331113131131331177
7733333333333333333333333333331131133311133333333111331311133313333133333333133333331133131331311177
7733333333333333333333333333311331333333333333333333331333331113333133333333333333333333333333333377
7733333333333333333333333333333333333333333333333333333333333333333333333333333333333333333333333377
7733333333333333333333333333333333333333333333333333333333333333333333333333333333333333333333333377
7733333333333333333333333333333333333333333333333333333333333333333333333333333333333333333333333377
7733333333333333333333333333333333333333333333333333333333333333333333333333333333333333333333333377
7733333333333333333333333333333333333333333333333333333333333333333333333333333333333333333333333377
7733333333333333333333333333333333333333333333333333333333333333333333333333333333333333333333333377
7733333333333333333333333333333333333333333333333333333333333333333333333333333333333333333333333377
7733333333333333333333333333333333333333333333333333333333333333333333333333333333333333333333333377
7733333333333333333333333333333333333333333333333333333333333333333333333333333333333333333333333377
7733333333333333333333333333333333333333333333333333333333333333333333333333333333333333333333333377
7733333333333333333333333333333333333333333333333333333333333333333333333333333333333333333333333377
7733333333333333333333333333333333333333333333333333333333333333333333333333333333333333333333333377
7733333333333333333333333333333333333333333333333333333333333333333333333333333333333333333333333377
7733333333333333333333333333333333333333333333333333333333333333333333333333333333333333333333333377
7733333333333333333333333333333333333333333333333333333333333333333333333333333333333333333333333377
7733333333333333333333333333333333333333333333333333333333333333333333333333333333333333333333333377
7733333333333333333333333333333333333333333333333333333333333333333333333333333333333333333333333377
7733333333333333333333333333333333333333333333333333333333333333333333333333333333333333333333333377
7733333333333333333333333333333333333333333333333333333333333333333333333333333333333333333333333377
7733333333333333333333333333333333333333333333333333333333333333333333333333333333333333333333333377
7733333333333333333333333333333333333333333333333333333333333333333333333333333333333333333333333377
7773333333333333333333333333333333333333333333333333333333333333333333333333333333333333333333333777
7777333333333333333333333333333333333333333333333333333333333333333333333333333333333333333333337777
7777777777777777777777777777777777777777777777777777777777777777777777777777777777777777777777777777
7777777777777777777777777777777777777777777777777777777777777777777777777777777777777777777777777777


