3333111111111111111111111111111111111111111111111111111111111111111111111111111111111111111111113333
3311111111111111111111111111111111111111111111111111111111111111111111111111111111111111111111111133
3111111111111111111111111111111111111111111111111111111111111111111111111111111111111111111111111113
3111555511111111111111111111111111111111111111155551111111111111111555511111111111111111111155551113
1115555551111111111111111111111111111111111111155551111111111111111555511111111111111111111555555111
1115555551116666666666666666666666666666666611155551110000000000111555511100000000000000111555555111
1115555551116666666666666666666666666666666611155551110000000000111555511100000000000000111555555111
1115555551116666666666666666666666666666666661111111100000000000011111111000000000000000111555555111
1111555511166666666666666666666777766666666661111111100000000000011111111000000000000000011155551111
1111111111166666666666666666667777776666666666611110000000000000000111100000000000000000011111111111
1111111111666666666666666666677777777666666666622220000000000000000111100000000000000000001111111111
1111111166666666666666666666677777777766666666622220000000000000000111100000000000000000000011111111
1111166666666666666666666666677777777766666666622220000000000000000111100000000000000000000000011111
1111166666666666666666666666667777777776666666622220000000000000000111100000000000000000000000011111
1111166666666666666666666666666777777776666666622220000000000000000111100000000000000000000000011111
1111166666666666666666666666666677777776666666622220000000000000000111100000000000000000000000011111
1111166666666666666666666666666677777776666666622220000000000000000111100000000000000000000000011111
1111166666666666666666666666666667777766666666622220000000000000000111100000000000000000000000011111
1111166666666666666666666666666666777666666666622220000000000000000111100000000000000000000000011111
1111166666666666666666666666666666666666666666622220000000000000000111100000000000000000000000011111
1111166666677766666666666666666666666666666666622220000000000000000111100000000000000000000000011111
1111166666777776666666666666666666666666666666622220000000000000000111100000000000000000000000011111
1111166666777776666666666666666666666666666666622220000000000000000111100000000000000000000000011111
1111166666777776666666666666666666666666666666622220000000000000000111100000000000000000000000011111
1111166667777776666666666666666666666666666666622220000000000000000111100000000000000000000000011111
1111166667777776666666666666666666666666666666622220000000000000011111111000000000000000000000011111
1111166667777776666666666666666666666666666666622220000000000000011111111000000000000000000000011111
1111166666777766666666666666666666666666666666622220000000000000111555511111110000000000000000011111
1111166666666666666666666666666666666666666666622220000000000000111555511111111000000000000000011111
1111166666666666666666666666666666666666666666622220000000000000111555511111111000000000000000011111
1111166666666666666666666666666666666666666666622220000000000000111555511111110000000000000000011111
1111166666666666666666666666666666666666666666622220000000000000011111111000000000000000000000011111
1111166666666666666666666666666666666666666666622220000000000000011111111000000000000000000000011111
1111166666666666666666666666666666666666666666622220000000000000000111100000000000000000000000011111
1111166666666666666666666666666666666666666662222222200000000000000000000000000000000000000000011111
1111166666666666666666666666666666666666666222222222222000000000000000000000000000000000000000011111
1111166666666666666666666666666666666666622222222222222220000000000000000000000000000000000000011111
1111166666666677776667777666666666666666222222222222222222000000000000000000000000000000000000011111
1111166666666777777777777766666666666662222222222222222222200000000000000000000000000000000000011111
1111166666666777777777777766666666666622222222444444222222220000000000000000000000000000000000011111
1111166666666777777777777766666666666222222244444444442222222000000000000000000000000000000000011111
1111166666666677777777777666666666666222222444444444444222222000000000000000000000000000000000011111
1111166666666667777777766666666666662222224444444444444422222200000000000000000000000000000000011111
1111111666666666666666666666666666662222244444444444444442222200000000000000000000000000000001111111
1111111116666666666666666666666666622222244444444444444442222220000000000000000000000000000111111111
1111111116666666666666666666666666622222444444444444444444222220000000000000000000000000000111111111
1115555111222222222222222222222222222222444444444444444444222222222222222222222222222222221115555111
1115555111222222222222222222222222222222444444444444444444222222222222222222222222222222221115555111
1115555111222222222222222222222222222222444444444444444444222222222222222222222222222222221115555111
1115555111222222222222222222222222222222444444444444444444222222222222222222222222222222221115555111
1111111110000000000000000000000000022222444444444444444444222223334443333333433333333333333111111111
1111111110000000000000000000000000022222244444444444444442222224333333433333334333333333343111111111
1111111000000000000000000000000000002222244444444444444442222234333333333333333333343343433431111111
1111100000000000000000000000000000002222224444444444444422222233343333334333334333333333333334411111
1111100000000000000000000000000000000222222444444444444222222334343333333333343333333343333334311111
1111100000000000000000000000000000000222222244444444442222222333333333333343333333333333333433311111
1111100000000000000000000000000000000022222222444444222222224333333333343333333333333433343433311111
1111100000000000000000000000000000000002222222222222222222234333333343333333343333333333334333311111
1111100000000000000000000000000000000000222222222222222222334333333333333333333333333433333333311111
1111100000000000000000000000000000000000022222222222222223333333333333333333333555333433343433311111
1111100000000000000000000000000000000000000222222222222333334343333343333333335555533333333333311111
1111100000000000000000000000000000000000000002222222233433333343443333334433335555553434333343311111
1111100000000000000000000000000000000000000000022223333333333333333333333333333555555334333343411111
1111100000000000000000000000000000000000000000022223333333333333333333433333333355555533333333311111
1111100000000000000000000000000000000000000000022223333333333334333333333333333335555553333333411111
1111111000000000000000000000000000000000000000022223333333333334333333333333333335555553433333311111
1111111110000000000000000000000000000000000000022223333433333333333433333333333335555555333333311111
1111111110000000000000000000000000000000000000022224333333333333333433433433334333555555333333311111
1115555111111100000000000000000000000000000000022223343433344333333333433333333333555555433333411111
1115555111111100000000000000000000000000000000022223343333333333333343333333333333555555533433411111
1115555111111100000000000000000000000000000000022224333343333333333433343443443333555555533333311111
1115555111111100000000000000000000000000000000022223333333333433333333333333334333555555543333311111
1111111110000000000000000000000000000000000000022223333333333433333333433333333333555555533333411111
1111111110000000000000000000000000000000000000022223333333333333333333343333433345555555533333311111
1111111000000000000000000000000000000000000000022223333443333333333333333334333335555555533333411111
1111100000000000000000000000000000000000000000022223333333334333333333333333433335555555533333311111
1111100000000000000000000000000000000000000000022223333333333333334333333434333355555555543433311111
1111100000000000000000000000000000000000000000022223334333333333333333433333333555555555334333411111
1111100000000000000000000000000000000000000000022223333333333333433333333333345555555555333333311111
1111100000000000000000000000000000000000000000022223333333333343333333333333355555555555333333311111
1111100000000000000000000000000000000000000000022223333333333555333333433333555555555553333333311111
1111100000000000000000000000000000000000000000022223334333335555555433333555555555555553333333411111
1111100000000000000000000000000000000000000000022223333343335555555555555555555555555533334333311111
1111100000000000000000000000000000000000000000022223433334333555555555555555555555555343343333311111
1111100000000000000000000000000000000000000000022224333333334355555555555555555555553433433333311111
1111100000000000000000000000000000000000000000022223443333333335555555555555555555533334333433411111
1111100000000000000000000111100000000000000000022223433333333433555555555555555555333343333333311111
1111100000000000000000000111100000000000000000022223333333333333435555555555555533333333334333311111
1111111100000000000000000111100000000000000000022223333333333333333335555555533333333333333411111111
1111111111000000000000000111100000000000000000022223333334333333333333333333334443343333331111111111
1111111111100000000000000111100000000000000000011113333333333433333433333333333333333333311111111111
1111555511100000000000011111111000000000000001111111133333333333333333333433333334333333311155551111
1115555551110000000000011111111000000000000001111111133333343333333333333333433333344433111555555111
1115555551110000000000111555511100000000000011155551113334333333333333333344333333333343111555555111
1115555551110000000000111555511100000000000011155551113333343333334333333333433333343333111555555111
1115555551111111111111111555511111111111111111155551111111111111111111111111111111111111111555555111
3111555511111111111111111555511111111111111111155551111111111111111111111111111111111111111155551113
3111111111111111111111111111111111111111111111111111111111111111111111111111111111111111111111111113
3311111111111111111111111111111111111111111111111111111111111111111111111111111111111111111111111133
3333111111111111111111111111111111111111111111111111111111111111111111111111111111111111111111113333
