8888888888888888888888888888888888888888888888888888888888888888888888888888888888888888888888888888
8888888888888888888888888888888888888888888888888888888888888888888888888888888888888888888888888888
8880000000000000000000000000000002000000000000000000000000000000000000000000000000000000000000000888
8800000000000000000000000000000000000000000000000000000000000000000000000000000000002000002000000088
8800000000000000000000000000000000200000000000000000000000000000002000000000000000000000000000000088
8800000000000000000000000000000000000000000000000000000000000000000000000000000000000000000000000088
8800000000000000000000020000000000000000000000000000000000000000000000000002000000000000000000000088
8800000000000000000002000000002000000000000000000000000000000000000000000202202202200000000000000088
8800000000000000000000000000200000000000002000202000020000000000000002000000000002222000000000000088
8800000000000000000000000000000000000000000000000000000002200000002002200002220000000000000000000088
8800000000000200000000000000000200000020002022000200200002000002000000000020110000002000002000000088
8800000000000000000000000000200200000000200020000020000000000000002002200002191020000020000000000088
8800000000020000000000020002000000200000000222200200002200000020200000002020199100200200000000000088
8800000000000000000000000002200000000000200200202200002202002022000022002020219910200000000000000088
8800000000000000000000000200000020200200000000022000002000002000222220220221119912000000000000000088
8800000002000000000000200200000000220200002000220002020020002220200202020021999912202000000000000088
8800000000000000000020020000000000222222020200000022200220222202222220202119999100220000000000000088
8800000000000002000000000200200220222022220000222002220002020220220020221199991100200000000000000088
8800000000000022002200020002200220000000200002222020000200002202222000001999912200000000200000000088
8800000000000022002200111220222002220000000022002020200002000002200200119999110022220002000000200088
8800000200000000002021999100222200222200022200000000222202222220202000199999100022202020000000000088
8800000020002000020019991020022200002000200000022220222020220222202001999991120000022020000000000088
8802000002202000000199912002002200022220200222222202022200222022222119999991222022202200000000000088
8800000000000020011999111111102200200200022202022222220222222200222199999911202022200002220000000088
8800000200020002199999999999111202202022202022221011222222222222221999999110022020020220000002000088
8800000000002001999999999999991111120222222222111111111111201220119999999120002222220000000000000088
8800020020002001119999999999999999111110222211111111111211111121199999991200022200022000202000000088
8800000000000002211111119999999999999911112111111111111111111111199999991220020200220200000200000088
8800000000200000002000211199999999999999911111111199999991111111999999912220002002000000000000000088
8800200020020000000020000119999999994999991111199999999999991119999999102020020200022022000000000088
8800000000202200020200220211119999999999999919999999999949999999949991120222020020022020220000000088
2800000000000000222222222002211111999999999999999999999999999999999911220220000202000022020000000088
8800020000002202002200020020202021111199999999994999999999999999991111220220020220222000002000000088
8802000200000022200200220020222222202111199999999999911999999999991112222022200022220000002200000088
8800000000000000002002202202022222020211199999999999111199949999991111022222002000220200220000200088
8800000000000002000220022020222022222111199999999991111199999999991111222202020222222020000200000088
8800000020000222220022002020020220222111999999999111111999999999999111122222200002220220020000000088
8800200000020202222220202220202022222111999999991111119999999994999121120002222020000200222000000088
8802000020200000020220000000222222222111999999991111119999999999999111102222022022000002200000000088
8800000000220002202202200222222022221119999999999111199999999999999911122222200000202200000000000088
8800020200000022002220202202020002221119999949999999999999991199999911122222200202200000000000000088
8800000000002000200222022222222222221119999999999999999999911119999911122222222002202202200020000088
8800002002000002200220202000022002211119999999999999999999911111999912120200222202020220022000000088
8800000000000002000000222220000222211219999999999999999499911111199911122020202000022200000000020088
8800000000200000200000222020022202011219999999999999999999911111199911112020020200202020020220000088
8800000000000002022020222000202202221119999999911111999999991111999911112222000200002000000000000088
8800000000000002222002022202202222221111999499111111199999999999999111120022200220222200000200000088
8800000000000220020020222020002222201111999999111111119999999999999111122220020000020200220000000088
8800020000000020200022000202202222022111999999911111119999999999999111122000000202220000000000000088
8800000000000000020000220000200220202111199999991111199994999999991111222222020002000020000000000088
8800000000000000022022022200002022002011199999999111999999999949991211222200222202002020000000200088
8800000000000000020000220202202222202011119999999999999999999999911111222002220020020000200000000088
8802000000000000002002000020200220202211111999949999999999999999111112222002220200200000000200002088
8800000000200000000002020002020222222211111199999999999999999991111122020022222020020000200000000088
8800000200200000200002020222200002220021111119999999999999999911111122222002020020020020000000000088
8800000000000022200002020000000022202222111111199999999999991111110020220020002000000020200000000088
8820000000000002200000220222020002222222210111111199999991112111112002220220020000020222000000000088
8800000000022000200220020202002202202022222211211119999111111111022022200000002202020002200020000088
8800220000020000000020000220202020220002222002111119999111111111200200020002220200000000022000000088
8800000020200020200002002000002202020022222220220119999111111022222200002200020200022220000000000088
8800000020000002200020000200002000002222022200001199999911202000200222002022222200200220002202000088
8800022000000000202000220222022222002022220202211999999112202222202222220202222200202020000202000088
8820200002000000000020002220020220020022002222219999999120200202222000222002222200202222200000000088
8802200002000000002020220222202002022020220222119999991222002202200002022222002002222200200000000288
8800222200200000020000000000000002002002022222119999911100020020220220220202002211222220022200202088
8822222020200022000000220020222222200000002219999991220202222222022002202221111111122202220200002888
8802200202000002200000222020000020202222000019999911122222202222202022202211111111111122222000000088
8820000220000000000000020000222020222020020119999112222020000222020202222111111111111112202000200288
8822002000000000200000020000000222222200200199991120222220000202022222211112111111121111202200020088
8822000202000200020002020000220002022202201999910220200020022202220202111111111111111111220222202088
8822202222000000000002000000002000002020001999112200020002022220222221111119999991111111122022000288
8802220220220220020200000000020022000000019991002002200000002222202211111199999999911111122002022288
1112022222222222000000000200002000200002019991000220000000002222222111111999999999991121110022220088
1121022002220000020002000022000020002202011999100000020220220000021111119999999999999111112022200088
1111110022000022002200000002000200002020201999100000022200220222021112119999999499999911112220200088
1111111022200222200020000020000000200002000199910020020222000022211112199999999999999911112222000088
1111111102202020000002000000000000000200022119910200220202202202211111999949999999999911112200020088
9991121120202000000200000200000000000200022019912222220202002222111111999999999999999111112022200288
9999111110220000000000000000000020200022200019911000002000222222111211999999994999999111120200200088
9999911111022022220000000000000000000002220001991000000000222222111111199999999999991111120202200088
9999991111020200020000000000020000000000200001991002200002222221111111199999999999111111122222200088
9499991111222222202000020000200000000002000001999110020022002201111111119999999911111110002022000088
9999991111100002020202000000000000000202002022199912000020022220111112111199991111111102020220000088
9999991111122020022000000000000000000000000000191100002000202022111112111111111121111220222200000088
9999491121122200002002002000020000000200002000110002000002202220211111111111111111120022022200200088
9999991111120222002000020000000000000000000000000000020200002220020111211111111111220020002000020088
9999991111102002002202020000000000000000002000200000200000020202222021111111111112220222022000000088
9999991111122200022220200000000000000000000200000000000000200002222022221120000000222222002020002088
9949991111122220000000200000000000000000000000020220000002020020000002222022022000222200000000002088
9999911111022200002200000000000002000000000000000000000222002200202000020220000000200020000000000088
9999111111220222000000000000200000000000000202000200200000200222200200000220000000000200000000000088
9991111110202202202020000000000200000020200000220000020020000202022200000200000002000200000000000088
1111211102200220220020000000000002000000022200000000000000020000000022000020000222020220000000000088
1111111122002200020000000000002000000000000000000000002000000020000000000000020022000000000000000088
1221111022222002200000000000000200002000000000000020000000020000000000000002020000200000000000000088
1111100000022200000000000000000000000200000000000000000200020000002000000000000000000000000000000088
1111122202000200002000020200000020000000000000000000000000000000000000000000000000000000000000000088
8880222220200202200000020000000000000000000000000000000000000000000000000020000000000000000000000888
8888888888888888888888888888888888888888888888888888888888888888888888888888888888888888888888888888
8888888888888888888888888888888888888888888888888888888888888888888888888888888888888888888888888888

single_spawn: (32,84)
chaser_spawns: [(25,38),(50,14),(82,36)]
